11 1 5 4 9 2 4 4 4 1 9 1 6 9 11 
8 2 1 10 4 3 3 10 2 3 10 1 8 2 2 
1 10 2 10 6 7 2 4 8 2 1 7 2 2 1 
3 10 6 9 11 2 4 6 10 8 5 5 3 6 8 
9 3 10 7 3 4 7 3 7 11 11 5 7 6 4 
10 3 8 3 9 10 6 3 3 11 5 1 8 4 6 
3 1 8 5 11 1 11 6 3 11 11 3 2 8 9 
3 3 1 9 4 7 4 1 9 3 4 1 7 11 10 
5 11 11 3 6 7 4 6 8 4 10 10 7 1 3 
11 9 2 2 1 9 11 2 1 11 8 9 1 3 10 
8 4 8 1 1 9 2 2 1 4 4 5 2 1 3 
8 8 10 2 11 6 10 7 10 9 5 1 9 1 6 
4 9 3 6 6 8 8 9 11 8 4 2 2 9 11 
10 10 8 3 5 8 2 1 11 7 4 5 9 2 2 
4 10 5 4 2 2 9 4 8 10 3 2 8 5 1 